XXXXXXXXXXXX
XOXOOOXOOOOX
XOXOXOXOXOOX
XOOOXOOOXOOX
XXXXXXXXXXXX